##########
#. .#    #
#     # ##
######  ##
#@   # ###
#        #
##########
