##########
#. .# #   #
#       # #
#########  ##
#@   #    #
#        #
#########