############
## #        ##
#       # # .#
#### ####  ##
#@   #    #
#        #
#########